111111111111111111111111111111111111111111111111111111111111	
	100000000000000000000000000000000000000000000000000000000021

100000000000000000000000000000000000000000000000000000000001
		100111111111111111111111111111111111111111111111111111111001
100100000000000000000000000000000000000000000000000000001001

		100100000000000000000000000000000000000000000000000000001001
100100000000000000000000000000000000000000000000000000001001

		100100000000000000000000000000000000000000000000000000001001

100100000000000000000000000000000000000000000000000000001001
		100100000000000000000000000000000000000000000000000000001001

100100000000000000000000000000000000000000000000000000001001	
	100100000000000000000000000000000000000000000000000000001001

100100000000000000000000000000000000000000000000000000001001
		100100000000000000000000000000000000000000000000000000001001

100100000000000000000000000000000000000000000000000000001001
		100100000000000000000000000000000000000000000000000000001001
100111111111111111111111111111111111111111111111111111111001

		100000000000000000000000000000000000000000000000000000000001

100000000000000000000000000000000000000000000000000000000001
		111111111111111111111111111111111111111111111111111111111111