111111111111111111111111111111111111111111111111111111111111	
	100000000000000000000000000000000000000000000000000000000021


100000000000000000000000000000000000000000000000000000000001
		100111111111111111111111111111111111100111111111111111001001

100100000001000000000000010000000110000001100000000000001001

		100100111001100011111000010001100000011000000110010000001001

100100100001000000000000010000000110000001100000010000001001

		100100100111011111111111000001111111100111111001110011111001


100100100000000000000000001001000000000000000000000000001001
		100000100111111111111111111001000000000000000000000000000001


100100100100000000000001000001001111111111111111111111001001	
	100100100100000011000001001101000000000001000000000000001001


100100000000000011000001001000000000010001000000000000001001
		100100100111111110000000000001111111110001000111110011111001


100100100100000000001111110000000000000000000000100000000001
		100100000000000000000000110000000000000000000000100000000001

100111111111110011111111111111111111111111111111100111111001

		100000000000000000000000000000000000000000000000000000000001


100000000000000000000000000000000000000000000000000000000001
		111111111111111111111111111111111111111111111111111111111111