111111111111111111111111111111111111111111111111111111111111	
	100000000000000000100000000000000000000000000000000000000001


111111111111111110100111111111111111111111111111111111111001
		100000000000000000100110000000000000000000000000000000011001

100110001110001111100110011111111111111111111111100110011001

		100110001110001111100000000000000000000000000000000110011001

100110001110001111111111111111111111111111111111111110011001

		100000000000000000100000000000000000000000000000000000011001


100111111000011110100111111111111111111111111111111111111001
		100000000000000000100100000001100000000000000000000000011001


111110000000001111100100111110000001100111000001110011011001	
	100000000000000000100100111000000110000111000001110011011001


100000111111000000100001100000011000000000000000000000011001
		100000000000000000100110000001100000000000011100001110011001


100000000111111000111000000110000111111000011100001110011001
		111111100000000000000000011000000111111000011100001110011001

100000000000000000000111100000000000000000000000000000011001

		101111111111111111100000000011111111111111111111111111111001


100000000000000000000111100000000000000000000000000000000001
		111111111111111111111111111111111111111111111111111111111111