111111111111111111111111111111111111111111111111111111111111	
	100000011100000110000000001000111000000000000000001111000001


100110000000000110011111001000000000011111111000000000011001
		100111100011110110000011001111111110000000000011110001111001

100100000000010110110011000011000011111111110010000000001001

		100100001000010000000000110000011000000000000010000100001001

100100001000011111111111111100011111111111111110000100001001

		100000001000000000000000000000000000000000000000000100000001


100011111111100011111111111100011111111111110001111111110001
		100000110001100010000000100001110000000010000001100000000001


100110000100000000010000000100000010000000010000000000111011	
	100111111111100011111111111111011111111111110001111111111011


100000001000000000000000000000000000000000000000000100000001
		100100001000011111111111111100011111111111111110000100001001


100100001000010000000000000000000000000000000010000100001001
		100100000000010001100111111100011111111111110010000000001001

100111100011110001100111111100000110000011000011110001111001

		100110000000110001100000001111110110110011001111100000000001


100000011100000001100000000000000000110000000000000000111001
		111111111111111111111111111111111111111111111111111111111111