111111111111111111111111111111111111111111111111111111111111	
	101000000000000000000000100000000000000000000000001000001001


100010100100111011111110101101111001101111110100011110101001
		101110100100100010000110101101000000001111110010100010101101

101000100100100010000010101101001000000000010001000010100101

		101000100100110110100000101101001000011000010000011000110101

101011100100010010110000101101111100000000010000000110100101

		101000100100011010111000100001000000011000000111101100101101


101000100111000010111100000001000001100001110000010100000001
		101110100100010010100000111100000111000001000000100100111001


100000000100010010100111110001011111000111111101000100000101	
	101110100100010110100000000011000000100000000010010000000101


101000100101110000100111110011000110010010101010010111101101
		101000100101000000100000010001000010000100101010100011001001


101000100101011110000000010001011011101000101010100000001001
		101011110101000010111011111101000101001100100010000111111001

100000000101000010010001000101000001000110000010100000001001

		111011111101011110000111110001011101000011110011100011111111


100000000000000000000000000000000000000000000000000000000001
		111111111111111111111111111111111111111111111111111111111111