111111111111111111111111111111111111111111111111111111111111	
	100000000000000000000000000000000000000000000000000000000001


100111111111111111111111111111111111111111111111111111101001
		100000000000000000000000000000000000000000000000000000001001

100101111111111111111111111111111111111111111111111110101001

		100100000000000100000000000000000000000000001000000000101001

100101011111110101111111111111100000000111001011111110101001

		100101000000000101000000000000011000000111001010000000101001


100101001111111101000001100000000110000000001010011111101001
		100101000000000101000000011000000000110000001010000000101001


100101111111100101000000000110000000001100001011111100101001	
	100101000000000101001110000001100000000000001010000000101001


100101011111111101001110000000011111111111111010111111101001
		100101000000000001000000000000000000000000000010000000001001


100101011111111111111111111111111111111111111111111111101001
		100100000000000000000000000000000000000000000000000000000001

100101111111111111111111111111111111111111111111111111111001

		100000000000000000000000000000000000000000000000000000000001


100000000000000000000000000000000000000000000000000000000001
		111111111111111111111111111111111111111111111111111111111111